20,20,20,19,06,12,00,00,00,00,00,00,10,01,02,13,16,17,21,20,20,20,20,20,20
20,20,20,24,26,06,12,00,00,00,00,09,05,12,10,02,13,13,16,17,21,20,20,20,20
20,20,20,20,24,26,06,12,00,00,00,10,02,06,12,10,01,01,01,02,16,21,20,20,20
20,20,20,20,20,24,26,06,05,05,12,00,10,02,07,00,00,00,00,10,02,16,17,21,20
20,20,20,20,20,20,24,25,26,13,06,05,12,10,11,00,00,00,00,00,10,02,13,16,17
20,20,20,20,20,20,20,20,24,25,26,13,06,12,00,00,00,00,00,00,00,10,02,13,13
20,20,20,20,20,20,20,20,20,20,24,26,13,07,00,00,00,00,00,00,00,00,10,02,13
20,20,20,20,20,20,20,20,20,20,20,19,13,07,00,00,00,00,00,00,00,00,00,10,01
20,20,20,20,20,22,21,20,20,20,22,18,08,11,00,00,09,05,05,12,00,00,00,00,00
20,20,20,20,20,19,16,21,20,22,18,08,11,00,09,05,04,13,13,07,00,00,00,00,00
20,20,20,20,20,24,26,15,20,19,08,11,00,09,04,14,25,25,26,07,00,00,00,00,00
20,20,20,20,20,20,24,23,22,18,06,05,05,04,14,23,20,20,19,07,00,00,00,00,00
20,20,20,20,20,20,20,22,18,08,01,01,02,13,16,21,20,22,18,07,09,05,12,00,00
20,20,20,20,20,20,22,18,13,07,00,00,10,02,13,16,17,18,08,11,03,13,06,12,00
20,20,20,20,20,22,18,13,08,11,00,00,00,10,01,01,01,01,11,00,03,13,13,07,00
22,17,17,17,17,18,13,08,11,00,00,00,00,00,00,00,00,00,00,00,03,13,13,06,12
19,08,01,01,01,01,01,11,00,00,00,00,00,00,00,00,00,00,00,00,10,02,13,13,07
19,07,00,00,00,00,00,00,00,09,05,05,12,00,00,00,00,00,00,00,00,10,02,13,06
19,06,12,00,00,00,09,05,05,04,13,13,06,12,00,00,00,00,00,00,00,00,10,02,13
19,13,06,05,12,00,03,14,25,25,25,25,26,06,12,00,00,00,00,00,00,00,00,10,01
19,13,14,25,25,25,25,23,20,20,20,20,24,26,06,05,12,00,00,00,00,00,00,00,00
19,13,15,20,20,20,20,20,20,20,20,20,20,24,25,26,07,00,00,00,00,00,00,00,00
19,13,16,17,21,20,20,20,20,20,22,17,21,20,20,19,07,00,00,00,00,00,00,00,00
24,26,13,13,15,20,20,20,20,20,19,13,15,20,20,19,06,12,00,00,00,00,00,00,00
20,24,25,25,23,20,20,20,20,20,19,13,15,20,20,24,26,07,00,00,00,00,00,00,00

